................................................................................
................................................................................
................................................................................
................................................................................
................................................................................
..........###########..............................###########..................
..........###########..............................###########..................
..........###########..............................###########..................
................................................................................
....................#######.....................................................
....................#######...............######................................
....................#######...............######................................
.........................................######.................................
..............####....................................................#####.....
..............####....................##########......................#####.....
..............####....................##########......................#####.....
......................................##########................................
....................#####.......................................................
....................#####.....................#####.............................
....................#####.....................#####.............................
................................................................................
...........####################.................................................
...........####################..............#########..........................
...........####################..............#########..........................
...........####################..............#########..........................
................................................................................
................................................................................
................................................................................
................................................................................
................................................................................
